1111111111111111111111111111111111111111111111111111111111111111111111111111111111111111111111111111111111
1111111111111111111111111111111111111111111111111111111111111111111111111111111111111111111111111111111111
1111111111111111111111111111111111111111111111111111111111111111111111111111111111111111111111111111111111
1111111111111111111111111111111111111111111111111111111111111111111111111111111111111111111111111111111111
1111111111111111111111111111111111111111111111111111111111111111111111111111111111111111111111111111111111
1111111111111111111111111111111111111111111111111111111111111111111111111111111111111111111111111111111111
1111111111111111111111111111111111111111111111111111111111111111111111111110000000000011111111111111111111
1111111111111111111111111111100000000111111111111111111111111111111111100000000000000000111111111111111111
1111111111111111111111111110000000000000111111111111111111111111111100000000000000000000001111111111111111
1111111111111111111111111000000000000000011111111111111111111110000000000000000000000000000111111111111111
1111111111111111000000110000000000000000000111111111111111110000000000000000000000000000000011111111111111
1111111111111110000000010000000000000000000011111111111111000000000000000000000000000000000001111111111111
1111111111111100000000000000000000000000000011111111000000000000000000000000000000000000000000111111111111
1111111111111100000000000000000000000000000001000000000000000000000000000000000000000000000000011111111111
1111111111111000000000000000000000000000000000000000000000000000000000000000000000000000000000011111111111
1111111111111000000000000000000000000000000000000000000000000000000000000000000000000000000000001111111111
1111111111110000000000000000000000000000000000000000000000000000000000000000000000000000000000001111111111
1111111111110000000000000000000000000000000000000000000000000000000000000000000000000000000000000111111111
1111111111100000000000000000000000000000000000000000000000000000000000000000000000000000000000000111111111
1111111111100000000000000000000000000000000000000000000000000000000000000000000000000000000000000111111111
1111111111100000000000000000000000000000000000000000000000000000000000000000000000000000000000000111111111
1111111111100000000000000000000000000000000000000000000000000000000000000000000000000000000000000111111111
1111111111100000000000000000000000000000000000000000000000000000000000000000000000000000000000000111111111
1111111111100000000000000000000000000000000000000000000000000000000000000000000000000000000000000111111111
1111111111100000000000000000000000000000000000000000000000000000000000000000000000000000000000001111111111
1111111111100000000000000000000000000000000000000000000000000000000000000000000000000000000000001111111111
1111111111000000000000000000000000000000000000000000000000000000000000000000000000000000000000001111111111
1111111111000000000000000000000000000000000000000000000000000000000000000000000000000000000000011111111111
1111111110000000000000000000000000000000000000000000000000000000000000000000000000000000000000011111111111
1111111110000000000000000000000000000000000000000000000000000000000000000000000000000000000000111111111111
1111111110000000000000000000000000000011111100000000000000000000001111111100000000000000000000111111111111
1111111110000000000000000000000000000111111111110000000000000000111111111111110000000000000000111111111111
1111111110000000000000000000000000001111111111111111111111001111111111111111111000000000000000011111111111
1111111110000000000000000000000000011111111111111111111111111111111111111111111000000000000000011111111111
1111111110000000000000000000000000011111111111111111111111111111111111111111111100000000000000001111111111
1111111110000000000000000000000000011111111111111111111111111111111111111111111100000000000000001111111111
1111111110000000000000000000000000011111111111111111111111111111111111111111111100000000000000001111111111
1111111110000000000000000000000000011111111111111111111111111111111111111111111100000000000000000111111111
1111111110000000000000000000000000001111111111111111111111111111111111111111111100000000000000000111111111
1111111110000000000000000000000000001111111111111111111111111111111111111111111000000000000000000011111111
1111111110000000000000000000000000000111111111111111111111111111111111111111111000000000000000000011111111
1111111110000000000000000000000000000001100000111111111111111111111111111111000000000000000000000011111111
1111111110000000000000000000000000000000000000011111111111111111100011111110000000000000000000000011111111
1111111110000000000000000000000000000000000000011111111111111110000001111100000000000000000000000011111111
1111111110000000000000000000000000000000000000001111111111111000000000000000000000000000000000000011111111
1111111111000000000000000000000000000000000000001111111111110000000000000000000000000000000000000001111111
1111111111000000000000000000000000000000000000001111111111100000000000000000000000000000000000000001111111
1111111111000000000000000000000000000000000000000111111111100000000000000000000000000000000000000001111111
1111111111100000000000000000000000000000000000000011111111000000000000000000000000000000000000000001111111
1111111111100000000000000000000000000000000000000000111100000000000000000000000000000000000000000011111111
1111111111110000000000000000000000000000000000000000000000000000000000000000000000000000000000000011111111
1111111111110000000000000000000000000000000000000000000000000000000000000000000000000000000000000011111111
1111111111110000000000000000000000000000000000000000000000000000000000000000000000000000000000000011111111
1111111111110000000000000000000000000000000000000000000000000000000000000000000000000000000000000011111111
1111111111110000000000000000000000000000000000000000000000000000000000000000000000000000000000000111111111
1111111111111000000000000000000000000000000000000000000000000000000000000000000000000000000000000111111111
1111111111111000000000000000000000000000000000000000000000000000000000000000000000000000000000000111111111
1111111111111100000000000000000000000000000000000000000000000000000000000000000000000000000000001111111111
1111111111111110000000000000000000000000000000000000000000000000000000000000000000000000000000011111111111
1111111111111111000000000000000000000000000000000000000000000000000000000000000000000000000000011111111111
1111111111111111111000000011111111110000000000000000000000000001100000000000000000000000000000111111111111
1111111111111111111111111111111111111000000000000000000000000011111000000000000000000000000001111111111111
1111111111111111111111111111111111111100000000000000000000000111111111000000000000000000000111111111111111
1111111111111111111111111111111111111111000000000000000000000111111111111111111110000000011111111111111111
1111111111111111111111111111111111111111100000000000000000001111111111111111111111111111111111111111111111
1111111111111111111111111111111111111111111000000000000000111111111111111111111111111111111111111111111111
1111111111111111111111111111111111111111111111000000000001111111111111111111111111111111111111111111111111
1111111111111111111111111111111111111111111111111111111111111111111111111111111111111111111111111111111111
1111111111111111111111111111111111111111111111111111111111111111111111111111111111111111111111111111111111
